
C 100,10,200

F 200,100,200


WEHFJKDSJFJKGDF ./texture/west64.xpm
EA ./texture/east64.xpm

NO ./texture/north64.xpm
SO ./texture/south64.xpm







11111
10001
10N01
10001
11111

sfdfsdfsaf