
F 220,10,100
C 225,30,100

NO ./texture/south64.xpm
SO ./texture/south64.xpm
WE ./texture/south64.xpm

EA ./texture/east64.xpm


        1111111111111111111111111
        1000000000110000000000001
        1011000001110000000E00001
        1001000000000000000000001
111111111011000001110000000000001
100000000011000001110111111111111
11110111111111011100000010001
11110111111111011101010010001
11000000110101011100000010001
10000000000000001100000010001
11111111111111111111111111111